{
  "map": {
    "id": "arena",
    "local": true,
    "legend": {
      "#": {
        "tileInfoId": "wall"
      },
      ".": {
        "tileInfoId": "ground"
      },
      "o": {
        "creatureInfoId": "orc"
      },
      "*": "spawn"
    },
    "data": [
      "################################################",
      "#..............................................#",
      "#..............................................#",
      "#..............................................#",
      "#..............................................#",
      "#..............................................#",
      "#..............................................#",
      "#..............................................#",
      "#..............................................#",
      "#..............................................#",
      "#...............o...............................#",
      "#..............................................#",
      "#..............................................#",
      "#..................o............................#",
      "#.....*.........................................#",
      "#..............................................#",
      "#...............o...............................#",
      "#..............................................#",
      "#..............................................#",
      "#..............................................#",
      "#..............................................#",
      "#..............................................#",
      "#..............................................#",
      "#..............................................#",
      "#..............................................#",
      "#..............................................#",
      "################################################"
    ]
  }
}