{
  "map": {
    "id": "arena",
    "local": true,
    "legend": {
      "#": {
        "tileInfoId": "wall"
      },
      ".": {
        "tileInfoId": "ground"
      },
      "*": "spawn"
    },
    "data": [
      "################################################",
      "#..............................................#",
      "#..............................................#",
      "#..............................................#",
      "#..............................................#",
      "#..............................................#",
      "#..............................................#",
      "#..............................................#",
      "#..............................................#",
      "#..............................................#",
      "#..............................................#",
      "#..............................................#",
      "#..............................................#",
      "#..............................................#",
      "#.....*.........................................#",
      "#..............................................#",
      "#..............................................#",
      "#..............................................#",
      "#..............................................#",
      "#..............................................#",
      "#..............................................#",
      "#..............................................#",
      "#..............................................#",
      "#..............................................#",
      "#..............................................#",
      "#..............................................#",
      "################################################"
    ]
  }
}