{
  "Map": {
    "Id": "BalHarbor",
    "Size": {
      "X": 48,
      "Y": 48
    },
    "Explored": true,
    "Local": true,
    "Legend": {
      "#": {
        "TileInfoId": "Wall"
      },
      ".": {
        "TileInfoId": "Ground"
      },
      "p": {
        "CreatureInfoId": "BalHarborInstructor"
      },
      "G": {
        "TileInfoId": "SignGuild"
      },
      ">": {
        "TileInfoId": "ExitDown"
      },
      "B": {
        "TileInfoId": "SignSmithy"
      },
      "`": {
        "TileInfoId": "OpenDoor"
      },
      "q": {
        "CreatureInfoId": "BalHarborWeaponMerchant"
      },
      "*": "Spawn"
    },
    "Data": [
      "#######################..#######################",
      "#..............................................#",
      "#..............................................#",
      "#..............................................#",
      "#..............................................#",
      "#................................#########.....#",
      "#................................#.......#.....#",
      "#................................#.......#.....#",
      "#................................#....p...#.....#",
      "#................................#.......#.....#",
      "#................................#.......#.....#",
      "#................................###...###.....#",
      "#.................................G............#",
      "#...#######....................................#",
      "#...#.....#....................................#",
      "#...#.....#....................................#",
      "#...#.....#....................................#",
      "#...#..........................................#",
      "#...#..........................................#",
      "#...#.....#.............*.......................#",
      "#...#.....#....................................#",
      "#...#.....#....................................#",
      "#...#######....................................#",
      "................................................",
      "................................................",
      "#..............................................#",
      "#..............................................#",
      "#..............................................#",
      "#......................>{Sewers1}.......................#",
      "#..............................................#",
      "#..............................................#",
      "#..............................................#",
      "#............................B.................#",
      "#.......................###`###................#",
      "#.......................#.....#................#",
      "#.......................#.....#................#",
      "#.......................#.....#................#",
      "#.......................#...q..#................#",
      "#.......................#.....#................#",
      "#.......................#.....#................#",
      "#.......................#.....#................#",
      "#.......................#######................#",
      "#..............................................#",
      "#..............................................#",
      "#..............................................#",
      "#..............................................#",
      "#..............................................#",
      "#######################..#######################"
    ]
  }
}