{
  "Map": {
    "Id": "BalHarbor",
    "Size": {
      "X": 35,
      "Y": 35
    },
    "Explored": true,
    "Light": true,
    "Local": true,
    "Legend": {
      "#": {
        "TileInfoId": "Wall"
      },
      ".": {
        "TileInfoId": "TownRoad"
      },
      "/": {
        "TileInfoId": "Ground"
      },
      "0": {
        "TileInfoId": "Floor"
      },
      "p": {
        "CreatureInfoId": "BalHarborWeaponMerchant"
      },
      "`": {
        "TileInfoId": "OpenDoor"
      },
      "B": {
        "TileInfoId": "SignSmithy"
      },
      "~": {
        "TileInfoId": "Water"
      },
      "G": {
        "TileInfoId": "SignGuild"
      },
      "q": {
        "CreatureInfoId": "BalHarborInstructor"
      },
      ">": {
        "TileInfoId": "ExitDown"
      },
      "*": "Spawn"
    },
    "Data": [
      "################...################",
      "#///////////////...///////////////#",
      "#///////////////...///////////////#",
      "#///////////////...///////////////#",
      "#///////////////...///////////////#",
      "#///////////////...///////////////#",
      "#///////////////...///////////////#",
      "#///////////////...///////////////#",
      "#///////////////...///#########///#",
      "#///////////////...///#0000000#///#",
      "#///////////////...///#0000000#///#",
      "#///////*////////...///#0000p000#///#",
      "#///////////////...///#0000000#///#",
      "#///////////////...///#0000000#///#",
      "#/////////////......./####`####///#",
      "#/////////////.#####.///B/////////#",
      "...............#~~~#...............",
      "...............#~~~#...............",
      "...............#~~~#...............",
      "#////////G////.#####./////////////#",
      "#//####`####//......./////////////#",
      "#//#0000000#////...///////////////#",
      "#//#0000000#////...///////////////#",
      "#//#0000q000#////...///////////////#",
      "#//#0000000#////...///////////////#",
      "#//#########////...///////////////#",
      "#///////////////...///////////////#",
      "#///////////////...///////////////#",
      "#//////>{Sewers1}////////...///////////////#",
      "#///////////////...///////////////#",
      "#///////////////...///////////////#",
      "#///////////////...///////////////#",
      "#///////////////.../0/////////////#",
      "#///////////////...///0///////////#",
      "################...################"
    ]
  }
}