{
  "Map": {
    "Size": {
      "X": "48",
      "Y": "48"
    },
    "Local": "True",
    "Id": "BalHarbor",
    "Legend": {
      "#": {
        "TileInfoId": "Wall"
      },
      ".": {
        "TileInfoId": "Ground"
      },
      ">": {
        "TileInfoId": "ExitDown"
      },
      "p": {
        "CreatureInfoId": "BalHarborWeaponMerchant"
      },
      "*": "Spawn"
    },
    "Data": [
      "#######################..#######################",
      "#..............................................#",
      "#..............................................#",
      "#..............................................#",
      "#..............................................#",
      "#................................#########.....#",
      "#................................#.......#.....#",
      "#................................#.......#.....#",
      "#................................#.......#.....#",
      "#................................#.......#.....#",
      "#................................#.......#.....#",
      "#................................###...###.....#",
      "#..............................................#",
      "#...#######....................................#",
      "#...#.....#....................................#",
      "#...#.....#....................................#",
      "#...#.....#....................................#",
      "#...#..........................................#",
      "#...#..........................................#",
      "#...#.....#.............*.......................#",
      "#...#.....#....................................#",
      "#...#.....#....................................#",
      "#...#######....................................#",
      "................................................",
      "................................................",
      "#..............................................#",
      "#..............................................#",
      "#..............................................#",
      "#......................>{Sewers1}.......................#",
      "#..............................................#",
      "#..............................................#",
      "#..............................................#",
      "#..............................................#",
      "#................###..############..###........#",
      "#................#......#......#......#........#",
      "#................#......#......#......#........#",
      "#................#......#......#......#........#",
      "#................#...p...#......#......#........#",
      "#................#....................#........#",
      "#................#......#......#......#........#",
      "#................#......#......#......#........#",
      "#................#......#......#......#........#",
      "#................######################........#",
      "#..............................................#",
      "#..............................................#",
      "#..............................................#",
      "#..............................................#",
      "#######################..#######################"
    ]
  }
}